--|---------|---------|
01|aaa       █         
02|   aa               
03|   aa               
04|~                   
05|~                   
06|~                   
07|~                   
08|~                   
09|~                   
10|~                   
11|~                   
12|~                   
13|~                   
14|<ame] [+] 3,6    All
15|-- INSERT --        

--|---------|---------|
01|00000000001222222222
02|00000000003333333333
03|00000000003333333333
04|44444444443333333333
05|44444444443333333333
06|44444444443333333333
07|44444444443333333333
08|44444444443333333333
09|44444444443333333333
10|44444444443333333333
11|44444444443333333333
12|44444444443333333333
13|44444444443333333333
14|55555555555555555555
15|66666666666677777777
