--|---------|---------|---------|---------|---------|
01| 4+ [No Name]  + [No Name]                       X
02|ax3xb                    │gx5xh                   
03|~                        │~                       
04|~                        │~                       
05|<o Name] [+] 1,1      All < Name] [+] 1,1      All
06|cx4xd                   │ex6xf                    
07|~                       │~                        
08|~                       │~                        
09|< Name] [+] 1,1      All <o Name] [+] 1,1      All
10|                                                  

--|---------|---------|---------|---------|---------|
01|00000000000000111111111111111111111111111111111111
02|23332333333333333333333334255525555555555555555555
03|66666666666666666666666664777777777777777777777777
04|66666666666666666666666664777777777777777777777777
05|88888888888888888888888888111111111111111111111111
06|25552555555555555555555542555255555555555555555555
07|77777777777777777777777747777777777777777777777777
08|77777777777777777777777747777777777777777777777777
09|11111111111111111111111111111111111111111111111111
10|55555555555555555555555555555555555555555555555555
