--|---------|---------|---------|
01|  a  aaa  a  aaa    █  ███ ███
02|        a a a a     ┃2    ████
03|                    ┃3        
04|  a  aaa  a  aaa    ┃4 ███ ███
05| a a a aaaaaaaaa    ┃5████████
06|                    ┃6        
07|  a  aaa  a  aaa    ┃7 ███ ███
08|        a a a a     ┃8    ████
09|a a a a a a a a     ┃9████████
10|  a  aaa  a  aaa    ┃+ ███ ███
11| a a a aaaaaaaaa    ┃+████████
12|a a a a a a a a     ┃ ████████
13|  a  aaa  a  aaa    ┃  ███ ███
14|        a a a a     ┃     ████
15| a a a a a a a a    ┃ ████████
16|  a  aaa  a  aaa    ┃  ███ ███
17| a a a aaaaaaaaa    ┃ ████████
18| a a a a a a a a    ┃ ████████
19|  a  aaa  a  aaa    ┃  ███ ███
20|        a a a a     ┃     ████
21|aaaaaaaaaaaaaaaa    ┃ ████████
22|  a  aaa  a  aaa    ┃  ███ ███
23| a a a aaaaaaaaa    ┃ ████████
24|aaaaaaaaaaaaaaaa    ┃ ████████
25|~                             
26|~                             
27|~                             
28|~                             
29|[No Name] [+]  1,1         All
30|                              

--|---------|---------|---------|
01|000000000000000000001233333333
02|000000000000000000004433333333
03|000000000000000000004433333333
04|000000000000000000004433333333
05|000000000000000000004433333333
06|000000000000000000004433333333
07|000000000000000000004433333333
08|000000000000000000004433333333
09|000000000000000000004433333333
10|000000000000000000004433333333
11|000000000000000000004433333333
12|000000000000000000004222222222
13|000000000000000000004222222222
14|000000000000000000004222222222
15|000000000000000000004222222222
16|000000000000000000004222222222
17|000000000000000000004222222222
18|000000000000000000004222222222
19|000000000000000000004222222222
20|000000000000000000004222222222
21|000000000000000000004222222222
22|000000000000000000004222222222
23|000000000000000000004222222222
24|000000000000000000004222222222
25|555555555555555555556666666666
26|555555555555555555556666666666
27|555555555555555555556666666666
28|555555555555555555556666666666
29|777777777777777777777777777777
30|888888888888888888888888888888
