--|---------|---------|---------|
01|        a a a a               
02|                             ┃
03|  a  aaa  a  aaa             ┃
04| a a a aaaaaaaaa             ┃
05|                             ┃
06|  a  aaa  a  aaa             ┃
07|        a a a a              ┃
08|a a a a a a a a              ┃
09|  a  aaa  a  aaa             ┃
10| a a a aaaaaaaaa             ┃
11|a a a a a a a a              ┃
12|  a  aaa  a  aaa             ┃
13|        a a a a              ┃
14| a a a a a a a a             ┃
15|  a  aaa  a  aaa             ┃
16| a a a aaaaaaaaa             ┃
17| a a a a a a a a             █
18|  a  aaa  a  aaa             ┃
19|        a a a a              ┃
20|aaaaaaaaaaaaaaaa             ┃
21|  a  aaa  a  aaa             ┃
22| a a a aaaaaaaaa             ┃
23|aaaaaaaaaaaaaaaa             ┃
24|~                            ┃
25|~                            ┃
26|~                            ┃
27|~                            ┃
28|~                             
29|[No Name] 15,1                
30|                              

--|---------|---------|---------|
01|000000000000000000000000000001
02|000000000000000000000000000002
03|000000000000000000000000000002
04|000000000000000000000000000002
05|000000000000000000000000000002
06|000000000000000000000000000002
07|000000000000000000000000000002
08|000000000000000000000000000002
09|000000000000000000000000000002
10|000000000000000000000000000002
11|000000000000000000000000000002
12|000000000000000000000000000002
13|000000000000000000000000000002
14|000000000000000000000000000002
15|000000000000000000000000000002
16|000000000000000000000000000002
17|000000000000000000000000000002
18|000000000000000000000000000002
19|000000000000000000000000000002
20|000000000000000000000000000002
21|000000000000000000000000000002
22|000000000000000000000000000002
23|000000000000000000000000000002
24|333333333333333333333333333332
25|333333333333333333333333333332
26|333333333333333333333333333332
27|333333333333333333333333333332
28|333333333333333333333333333331
29|444444444444444444444444444444
30|555555555555555555555555555555
