--|---------|---------|---------|
01|        a a a a        🬀🬁🬂🬃🬄🬅🬆
02|a a a a a a a a       🬇🬈🬉🬊🬋🬌🬍🬎
03|  a  aaa  a  aaa    ┃ 🬏🬐🬑🬒🬓▌🬔🬕
04| a a a aaaaaaaaa    ┃ 🬖🬗🬘🬙🬚🬛🬜🬝
05|a a a a a a a a     ┃ 🬞🬟🬠🬡🬢🬣🬤🬥
06|  a  aaa  a  aaa    ┃ 🬦🬧▐🬨🬩🬪🬫🬬
07|        a a a a     █ 🬭🬮🬯🬰🬱🬲🬳🬴
08| a a a a a a a a    ┃ 🬵🬶🬷🬸🬹🬺🬻█
09|  a  aaa  a  aaa              
10| a a a aaaaaaaaa              
11| a a a a a a a a              
12|  a  aaa  a  aaa              
13|        a a a a               
14|aaaaaaaaaaaaaaaa              
15|  a  aaa  a  aaa              
16| a a a aaaaaaaaa              
17|aaaaaaaaaaaaaaaa              
18|~                             
19|~                             
20|~                             
21|~                             
22|~                             
23|~                             
24|~                             
25|~                             
26|~                             
27|~                             
28|~                             
29|[No Name] [+]  21,1        Bot
30|                              

--|---------|---------|---------|
01|000000000000000000001111111111
02|000000000000000000001111111111
03|000000000000000000002111111111
04|000000000000000000002111111111
05|000000000000000000002111111111
06|000000000000000000002111111111
07|000000000000000000003111111111
08|000000000000000000002111111111
09|000000000000000000004444444444
10|000000000000000000004444444444
11|000000000000000000004444444444
12|000000000000000000004444444444
13|000000000000000000004444444444
14|000000000000000000004444444444
15|000000000000000000004444444444
16|000000000000000000004444444444
17|000000000000000000004444444444
18|555555555555555555554444444444
19|555555555555555555554444444444
20|555555555555555555554444444444
21|555555555555555555554444444444
22|555555555555555555554444444444
23|555555555555555555554444444444
24|555555555555555555554444444444
25|555555555555555555554444444444
26|555555555555555555554444444444
27|555555555555555555554444444444
28|555555555555555555554444444444
29|666666666666666666666666666666
30|777777777777777777777777777777
