--|---------|---------|
01|aaa       █2🬂🬧🬓     
02|   aa               
03|   aa               
04|~                   
05|~                   
06|~                   
07|~                   
08|~                   
09|~                   
10|~                   
11|~                   
12|~                   
13|~                   
14|<ame] [+] 3,6    All
15|-- INSERT --        

--|---------|---------|
01|00000000001233344444
02|00000000005555555555
03|00000000005555555555
04|66666666665555555555
05|66666666665555555555
06|66666666665555555555
07|66666666665555555555
08|66666666665555555555
09|66666666665555555555
10|66666666665555555555
11|66666666665555555555
12|66666666665555555555
13|66666666665555555555
14|77777777777777777777
15|88888888888899999999
