--|---------|---------|---------|
01|  a  aaa  a  aaa    ┃3 🬀🬁🬂🬃🬄🬅🬆
02|        a a a a     ┃ 🬇🬈🬉🬊🬋🬌🬍🬎
03|                    ┃3🬏🬐🬑🬒🬓▌🬔🬕
04|  a  aaa  a  aaa    ┃3🬖🬗🬘🬙🬚🬛🬜🬝
05| a a a aaaaaaaaa    █ 🬞🬟🬠🬡🬢🬣🬤🬥
06|                    ┃ 🬦🬧▐🬨🬩🬪🬫🬬
07|  a  aaa  a  aaa    ┃ 🬭🬮🬯🬰🬱🬲🬳🬴
08|        a a a a     ┃ 🬵🬶🬷🬸🬹🬺🬻█
09|a a a a a a a a               
10|  a  aaa  a  aaa              
11| a a a aaaaaaaaa              
12|a a a a a a a a               
13|  a  aaa  a  aaa              
14|        a a a a               
15| a a a a a a a a              
16|  a  aaa  a  aaa              
17| a a a aaaaaaaaa              
18| a a a a a a a a              
19|  a  aaa  a  aaa              
20|        a a a a               
21|aaaaaaaaaaaaaaaa              
22|  a  aaa  a  aaa              
23| a a a aaaaaaaaa              
24|aaaaaaaaaaaaaaaa              
25|~                             
26|~                             
27|~                             
28|~                             
29|[No Name] [+]  15,1        All
30|                              

--|---------|---------|---------|
01|000000000000000000001233333333
02|000000000000000000001244444444
03|000000000000000000001255555555
04|000000000000000000001233333333
05|000000000000000000001222222222
06|000000000000000000001222222222
07|000000000000000000001222222222
08|000000000000000000001233333333
09|000000000000000000006666666666
10|000000000000000000006666666666
11|000000000000000000006666666666
12|000000000000000000006666666666
13|000000000000000000006666666666
14|000000000000000000006666666666
15|000000000000000000006666666666
16|000000000000000000006666666666
17|000000000000000000006666666666
18|000000000000000000006666666666
19|000000000000000000006666666666
20|000000000000000000006666666666
21|000000000000000000006666666666
22|000000000000000000006666666666
23|000000000000000000006666666666
24|000000000000000000006666666666
25|777777777777777777776666666666
26|777777777777777777776666666666
27|777777777777777777776666666666
28|777777777777777777776666666666
29|888888888888888888888888888888
30|999999999999999999999999999999
