--|---------|---------|---------|
01|  a  aaa  a  aaa            █ 
02|        a a a a             ┃ 
03|                            ┃ 
04|  a  aaa  a  aaa            ┃ 
05| a a a aaaaaaaaa            ┃ 
06|                            ┃ 
07|  a  aaa  a  aaa            ┃ 
08|        a a a a             ┃ 
09|a a a a a a a a             ┃ 
10|  a  aaa  a  aaa            ┃ 
11| a a a aaaaaaaaa            ┃ 
12|a a a a a a a a             ┃ 
13|  a  aaa  a  aaa            ┃ 
14|        a a a a             ┃ 
15| a a a a a a a a            ┃ 
16|  a  aaa  a  aaa            ┃ 
17| a a a aaaaaaaaa            ┃ 
18| a a a a a a a a            ┃ 
19|  a  aaa  a  aaa            ┃ 
20|        a a a a             ┃ 
21|aaaaaaaaaaaaaaaa            ┃ 
22|  a  aaa  a  aaa            ┃ 
23| a a a aaaaaaaaa            ┃ 
24|aaaaaaaaaaaaaaaa            ┃ 
25|~                           ┃ 
26|~                           ┃ 
27|~                           ┃ 
28|~                             
29|[No Name] [+]  1,1         All
30|                              

--|---------|---------|---------|
01|000000000000000000000000000012
02|000000000000000000000000000012
03|000000000000000000000000000012
04|000000000000000000000000000012
05|000000000000000000000000000012
06|000000000000000000000000000012
07|000000000000000000000000000012
08|000000000000000000000000000012
09|000000000000000000000000000012
10|000000000000000000000000000012
11|000000000000000000000000000012
12|000000000000000000000000000012
13|000000000000000000000000000012
14|000000000000000000000000000012
15|000000000000000000000000000012
16|000000000000000000000000000012
17|000000000000000000000000000012
18|000000000000000000000000000012
19|000000000000000000000000000012
20|000000000000000000000000000012
21|000000000000000000000000000012
22|000000000000000000000000000012
23|000000000000000000000000000012
24|000000000000000000000000000012
25|333333333333333333333333333312
26|333333333333333333333333333312
27|333333333333333333333333333312
28|333333333333333333333333333322
29|444444444444444444444444444444
30|555555555555555555555555555555
