--|---------|---------|---------|
01|aa aa aa              █▐▌█    
02|aa aa aa              █▐▌█    
03|aa aa aa              █▐▌█    
04|aa aa aa              █▐▌█    
05|aa aa aa              █▐▌█    
06|aa aa aa              █▐▌█    
07|aa aa aa              █▐▌█    
08|aa aa aa              █▐▌█    
09|aa aa aa                      
10|aa aa aa                      
11|aa aa aa                      
12|aa aa aa                      
13|aa aa aa                      
14|aa aa aa                      
15|aa aa aa                      
16|aa aa aa                      
17|aa aa aa                      
18|aa aa aa                      
19|aa aa aa                      
20|aa aa aa                      
21|aa aa aa                      
22|aa aa aa                      
23|aa aa aa                      
24|aa aa aa                      
25|~                             
26|~                             
27|~                             
28|~                             
29|[No Name] [+]  15,1        All
30|                              

--|---------|---------|---------|
01|000000000000000000001111111111
02|000000000000000000001111111111
03|000000000000000000001111111111
04|000000000000000000001111111111
05|000000000000000000001111111111
06|000000000000000000001111111111
07|000000000000000000001111111111
08|000000000000000000001111111111
09|000000000000000000002222222222
10|000000000000000000002222222222
11|000000000000000000002222222222
12|000000000000000000002222222222
13|000000000000000000002222222222
14|000000000000000000002222222222
15|000000000000000000002222222222
16|000000000000000000002222222222
17|000000000000000000002222222222
18|000000000000000000002222222222
19|000000000000000000002222222222
20|000000000000000000002222222222
21|000000000000000000002222222222
22|000000000000000000002222222222
23|000000000000000000002222222222
24|000000000000000000002222222222
25|333333333333333333332222222222
26|333333333333333333332222222222
27|333333333333333333332222222222
28|333333333333333333332222222222
29|444444444444444444444444444444
30|555555555555555555555555555555
