--|---------|---------|---------|
01|  a  aaa  a  aaa           >< 
02|        a a a a            ┃  
03|                           ┃  
04|  a  aaa  a  aaa           ┃  
05| a a a aaaaaaaaa           ┃  
06|                           ┃  
07|  a  aaa  a  aaa           ┃  
08|        a a a a            ┃  
09|a a a a a a a a            ┃  
10|  a  aaa  a  aaa           ┃  
11| a a a aaaaaaaaa           ┃  
12|a a a a a a a a            ┃  
13|  a  aaa  a  aaa           ┃  
14|        a a a a            ┃  
15| a a a a a a a a           ┃  
16|  a  aaa  a  aaa           ┃  
17| a a a aaaaaaaaa           ┃  
18| a a a a a a a a           ┃  
19|  a  aaa  a  aaa           ┃  
20|        a a a a            ┃  
21|aaaaaaaaaaaaaaaa           ┃  
22|  a  aaa  a  aaa           ┃  
23| a a a aaaaaaaaa           ┃  
24|aaaaaaaaaaaaaaaa           ┃  
25|~                          ┃  
26|~                          ┃  
27|~                          ┃  
28|~                             
29|[No Name] [+]  1,1         All
30|                              

--|---------|---------|---------|
01|000000000000000000000000000112
02|000000000000000000000000000322
03|000000000000000000000000000322
04|000000000000000000000000000322
05|000000000000000000000000000322
06|000000000000000000000000000322
07|000000000000000000000000000322
08|000000000000000000000000000322
09|000000000000000000000000000322
10|000000000000000000000000000322
11|000000000000000000000000000322
12|000000000000000000000000000322
13|000000000000000000000000000322
14|000000000000000000000000000322
15|000000000000000000000000000322
16|000000000000000000000000000322
17|000000000000000000000000000322
18|000000000000000000000000000322
19|000000000000000000000000000322
20|000000000000000000000000000322
21|000000000000000000000000000322
22|000000000000000000000000000322
23|000000000000000000000000000322
24|000000000000000000000000000322
25|444444444444444444444444444322
26|444444444444444444444444444322
27|444444444444444444444444444322
28|444444444444444444444444444222
29|555555555555555555555555555555
30|666666666666666666666666666666
