--|---------|---------|---------|---------|---------|
01| 4+ [No Name]  + [No Name]                       X
02|ax3xb                    │gx5xh                   
03|~                        │~                       
04|~                        │~                       
05|<o Name] [+] 1,1      All < Name] [+] 1,1      All
06|cx4xd                   │ex6xf                    
07|~                       │~                        
08|~                       │~                        
09|< Name] [+] 1,1      All <o Name] [+] 1,1      All
10|                                                  

--|---------|---------|---------|---------|---------|
01|01000000000000222222222222233333333333333333333332
02|45554555555555555555555556455545555555555555555555
03|77777777777777777777777776777777777777777777777777
04|77777777777777777777777776777777777777777777777777
05|88888888888888888888888888333333333333333333333333
06|45554555555555555555555564555455555555555555555555
07|77777777777777777777777767777777777777777777777777
08|77777777777777777777777767777777777777777777777777
09|33333333333333333333333333333333333333333333333333
10|66666666666666666666666666666666666666666666666666
