--|---------|---------|---------|
01|  a  aaa  a  aaa             █
02|        a a a a              ┃
03|                             ┃
04|  a  aaa  a  aaa             ┃
05| a a a aaaaaaaaa             ┃
06|                             ┃
07|  a  aaa  a  aaa             ┃
08|        a a a a              ┃
09|a a a a a a a a              ┃
10|  a  aaa  a  aaa             ┃
11| a a a aaaaaaaaa             ┃
12|a a a a a a a a              ┃
13|  a  aaa  a  aaa             ┃
14|        a a a a              ┃
15| a a a a a a a a             ┃
16|  a  aaa  a  aaa             ┃
17| a a a aaaaaaaaa             ┃
18| a a a a a a a a             ┃
19|  a  aaa  a  aaa             ┃
20|        a a a a              ┃
21|aaaaaaaaaaaaaaaa             ┃
22|  a  aaa  a  aaa             ┃
23| a a a aaaaaaaaa             ┃
24|aaaaaaaaaaaaaaaa             ┃
25|~                            ┃
26|~                            ┃
27|~                            ┃
28|~                             
29|[No Name] [+]  1,1         All
30|                              

--|---------|---------|---------|
01|000000000000000000000000000001
02|000000000000000000000000000001
03|000000000000000000000000000001
04|000000000000000000000000000001
05|000000000000000000000000000001
06|000000000000000000000000000001
07|000000000000000000000000000001
08|000000000000000000000000000001
09|000000000000000000000000000001
10|000000000000000000000000000001
11|000000000000000000000000000001
12|000000000000000000000000000001
13|000000000000000000000000000001
14|000000000000000000000000000001
15|000000000000000000000000000001
16|000000000000000000000000000001
17|000000000000000000000000000001
18|000000000000000000000000000001
19|000000000000000000000000000001
20|000000000000000000000000000001
21|000000000000000000000000000001
22|000000000000000000000000000001
23|000000000000000000000000000001
24|000000000000000000000000000001
25|222222222222222222222222222221
26|222222222222222222222222222221
27|222222222222222222222222222221
28|222222222222222222222222222223
29|444444444444444444444444444444
30|555555555555555555555555555555
