--|---------|---------|---------|
01|  a  aaa  a  aaa    █2 🬐🬠🬰🬀🬐🬡🬰
02|        a a a a     ┃2🬁🬅🬉🬍🬒🬕🬙🬝
03|                    ┃ 🬮🬲🬶🬺🬮🬲🬶🬺
04|  a  aaa  a  aaa    ┃ 🬞🬟🬠🬡🬢🬣🬤🬥
05| a a a aaaaaaaaa      🬇🬗▐🬸🬋🬛🬫█
06|                      🬩🬹🬩🬹🬺🬺🬺🬺
07|  a  aaa  a  aaa      🬂🬆🬊🬎🬒🬕🬙🬝
08|        a a a a      2🬇🬈🬉🬊🬋🬌🬍🬎
09|a a a a a a a a       🬏🬐🬯🬰🬓▌🬳🬴
10|  a  aaa  a  aaa      🬅🬔🬤🬳🬆🬕🬥🬴
11| a a a aaaaaaaaa      🬠🬤▐🬫🬰🬴🬸█
12|a a a a a a a a       🬯🬳🬷🬻🬳🬳🬻🬻
13|  a  aaa  a  aaa      🬵🬶🬷🬸🬹🬺🬻█
14|[No Name] [+]  1,1         Top
15|                              

--|---------|---------|---------|
01|000000000000000000001233333333
02|000000000000000000002233333333
03|000000000000000000002444444444
04|000000000000000000002433333333
05|000000000000000000004444444444
06|000000000000000000004433333333
07|000000000000000000004433333333
08|000000000000000000004233333333
09|000000000000000000004433333333
10|000000000000000000004444444444
11|000000000000000000004433333333
12|000000000000000000004433333333
13|000000000000000000004444444444
14|555555555555555555555555555555
15|666666666666666666666666666666
