--|---------|---------|---------|
01|  a  aaa  a  aaa             █
02|        a a a a              ┃
03|                             ┃
04|  a  aaa  a  aaa             ┃
05| a a a aaaaaaaaa             ┃
06|                             ┃
07|  a  aaa  a  aaa             ┃
08|        a a a a              ┃
09|a a a a a a a a              ┃
10|  a  aaa  a  aaa             ┃
11| a a a aaaaaaaaa             ┃
12|a a a a a a a a              ┃
13|  a  aaa  a  aaa             ┃
14|        a a a a              ┃
15| a a a a a a a a             ┃
16|  a  aaa  a  aaa             ┃
17| a a a aaaaaaaaa             ┃
18| a a a a a a a a             ┃
19|  a  aaa  a  aaa             ┃
20|        a a a a              ┃
21|aaaaaaaaaaaaaaaa             ┃
22|  a  aaa  a  aaa             ┃
23| a a a aaaaaaaaa             ┃
24|aaaaaaaaaaaaaaaa             ┃
25|~                            ┃
26|~                            ┃
27|~                            ┃
28|~                             
29|[No Name] [+]  1,1         All
30|                              

--|---------|---------|---------|
01|000000000000000000000000000001
02|000000000000000000000000000002
03|000000000000000000000000000002
04|000000000000000000000000000002
05|000000000000000000000000000002
06|000000000000000000000000000002
07|000000000000000000000000000002
08|000000000000000000000000000002
09|000000000000000000000000000002
10|000000000000000000000000000002
11|000000000000000000000000000002
12|000000000000000000000000000002
13|000000000000000000000000000002
14|000000000000000000000000000002
15|000000000000000000000000000002
16|000000000000000000000000000002
17|000000000000000000000000000002
18|000000000000000000000000000002
19|000000000000000000000000000002
20|000000000000000000000000000002
21|000000000000000000000000000002
22|000000000000000000000000000002
23|000000000000000000000000000002
24|000000000000000000000000000002
25|333333333333333333333333333332
26|333333333333333333333333333332
27|333333333333333333333333333332
28|333333333333333333333333333334
29|555555555555555555555555555555
30|666666666666666666666666666666
