--|---------|---------|---------|
01|  a  aaa  a  aaa    █2 🬐🬠🬰🬀🬐🬡🬰
02|        a a a a     ┃2🬁🬅🬉🬍🬒🬕🬙🬝
03|                    ┃ 🬮🬲🬶🬺🬮🬲🬶🬺
04|  a  aaa  a  aaa    ┃ 🬞🬟🬠🬡🬢🬣🬤🬥
05| a a a aaaaaaaaa      🬇🬗▐🬸🬋🬛🬫█
06|                      🬩🬹🬩🬹🬺🬺🬺🬺
07|  a  aaa  a  aaa      🬂🬆🬊🬎🬒🬕🬙🬝
08|        a a a a      2🬇🬈🬉🬊🬋🬌🬍🬎
09|a a a a a a a a       🬏🬐🬯🬰🬓▌🬳🬴
10|  a  aaa  a  aaa      🬅🬔🬤🬳🬆🬕🬥🬴
11| a a a aaaaaaaaa      🬠🬤▐🬫🬰🬴🬸█
12|a a a a a a a a       🬯🬳🬷🬻🬳🬳🬻🬻
13|  a  aaa  a  aaa      🬵🬶🬷🬸🬹🬺🬻█
14|[No Name] [+]  1,1         Top
15|                              

--|---------|---------|---------|
01|000000000000000000001233333333
02|000000000000000000002233333333
03|000000000000000000002333333333
04|000000000000000000002333333333
05|000000000000000000003333333333
06|000000000000000000003333333333
07|000000000000000000003333333333
08|000000000000000000003233333333
09|000000000000000000003333333333
10|000000000000000000003333333333
11|000000000000000000003333333333
12|000000000000000000003333333333
13|000000000000000000003333333333
14|444444444444444444444444444444
15|555555555555555555555555555555
