--|---------|---------|---------|
01|  a  aaa  a  aaa    ┃8 🬀🬁🬂🬃🬄🬅🬆
02|        a a a a     ┃8🬇🬈🬉🬊🬋🬌🬍🬎
03|                    ┃+🬏🬐🬑🬒🬓▌🬔🬕
04|  a  aaa  a  aaa    ┃+🬖🬗🬘🬙🬚🬛🬜🬝
05| a a a aaaaaaaaa    █+🬞🬟🬠🬡🬢🬣🬤🬥
06|                    ┃+🬦🬧▐🬨🬩🬪🬫🬬
07|  a  aaa  a  aaa    ┃8🬭🬮🬯🬰🬱🬲🬳🬴
08|        a a a a     ┃8🬵🬶🬷🬸🬹🬺🬻█
09|a a a a a a a a               
10|  a  aaa  a  aaa              
11| a a a aaaaaaaaa              
12|a a a a a a a a               
13|  a  aaa  a  aaa              
14|        a a a a               
15| a a a a a a a a              
16|  a  aaa  a  aaa              
17| a a a aaaaaaaaa              
18| a a a a a a a a              
19|  a  aaa  a  aaa              
20|        a a a a               
21|aaaaaaaaaaaaaaaa              
22|  a  aaa  a  aaa              
23| a a a aaaaaaaaa              
24|aaaaaaaaaaaaaaaa              
25|~                             
26|~                             
27|~                             
28|~                             
29|[No Name] 15,3                
30|/ a    ... [56/94]            

--|---------|---------|---------|
01|011011000110110000002344444444
02|000000011111111000002344444444
03|000000000000000000002344444444
04|011011000110110000002344444444
05|111111110000000000002344444444
06|000000000000000000002344444444
07|011011000110110000002344444444
08|000000011111111000002344444444
09|011111111111111000005555555555
10|011011000110110000005555555555
11|111111110000000000005555555555
12|011111111111111000005555555555
13|011011000110110000005555555555
14|000000011111111000005555555555
15|116611111111111100005555555555
16|011011000110110000005555555555
17|111111110000000000005555555555
18|111111111111111100005555555555
19|011011000110110000005555555555
20|000000011111111000005555555555
21|000000000000000000005555555555
22|011011000110110000005555555555
23|111111110000000000005555555555
24|000000000000000000005555555555
25|777777777777777777775555555555
26|777777777777777777775555555555
27|777777777777777777775555555555
28|777777777777777777775555555555
29|888888888888888888888888888888
30|999999999999999999999999999999
