--|---------|---------|---------|
01|  a  aaa  a  aaa    █  ███ ███
02|        a a a a     ┃2    ████
03|                    ┃3        
04|  a  aaa  a  aaa    ┃4 ███ ███
05| a a a aaaaaaaaa    ┃5████████
06|                    ┃6        
07|  a  aaa  a  aaa    ┃7 ███ ███
08|        a a a a     ┃8    ████
09|a a a a a a a a     ┃9████████
10|  a  aaa  a  aaa    ┃+ ███ ███
11| a a a aaaaaaaaa    ┃+████████
12|a a a a a a a a     ┃ ████████
13|  a  aaa  a  aaa    ┃  ███ ███
14|        a a a a     ┃     ████
15| a a a a a a a a    ┃ ████████
16|  a  aaa  a  aaa    ┃  ███ ███
17| a a a aaaaaaaaa    ┃ ████████
18| a a a a a a a a    ┃ ████████
19|  a  aaa  a  aaa    ┃  ███ ███
20|        a a a a     ┃     ████
21|aaaaaaaaaaaaaaaa    ┃ ████████
22|  a  aaa  a  aaa    ┃  ███ ███
23| a a a aaaaaaaaa    ┃ ████████
24|aaaaaaaaaaaaaaaa    ┃ ████████
25|~                             
26|~                             
27|~                             
28|~                             
29|[No Name] [+]  1,1         All
30|                              

--|---------|---------|---------|
01|000000000000000000001222222222
02|000000000000000000003322222222
03|000000000000000000003322222222
04|000000000000000000003322222222
05|000000000000000000003322222222
06|000000000000000000003322222222
07|000000000000000000003322222222
08|000000000000000000003322222222
09|000000000000000000003322222222
10|000000000000000000003322222222
11|000000000000000000003322222222
12|000000000000000000003222222222
13|000000000000000000003222222222
14|000000000000000000003222222222
15|000000000000000000003222222222
16|000000000000000000003222222222
17|000000000000000000003222222222
18|000000000000000000003222222222
19|000000000000000000003222222222
20|000000000000000000003222222222
21|000000000000000000003222222222
22|000000000000000000003222222222
23|000000000000000000003222222222
24|000000000000000000003222222222
25|444444444444444444445555555555
26|444444444444444444445555555555
27|444444444444444444445555555555
28|444444444444444444445555555555
29|666666666666666666666666666666
30|777777777777777777777777777777
