--|---------|---------|---------|
01|  a  aaa  a  aaa    █2 🬀🬁🬂🬃🬄🬅🬆
02|        a a a a     ┃ 🬇🬈🬉🬊🬋🬌🬍🬎
03|                    ┃ 🬏🬐🬑🬒🬓▌🬔🬕
04|  a  aaa  a  aaa    ┃ 🬖🬗🬘🬙🬚🬛🬜🬝
05| a a a aaaaaaaaa    ┃ 🬞🬟🬠🬡🬢🬣🬤🬥
06|                    ┃ 🬦🬧▐🬨🬩🬪🬫🬬
07|  a  aaa  a  aaa    ┃ 🬭🬮🬯🬰🬱🬲🬳🬴
08|        a a a a     ┃ 🬵🬶🬷🬸🬹🬺🬻█
09|a a a a a a a a     ┃2 🬀🬁🬂🬃🬄🬅🬆
10|  a  aaa  a  aaa    ┃ 🬇🬈🬉🬊🬋🬌🬍🬎
11| a a a aaaaaaaaa      🬏🬐🬑🬒🬓▌🬔🬕
12|a a a a a a a a       🬖🬗🬘🬙🬚🬛🬜🬝
13|  a  aaa  a  aaa      🬞🬟🬠🬡🬢🬣🬤🬥
14|        a a a a       🬦🬧▐🬨🬩🬪🬫🬬
15| a a a a a a a a      🬭🬮🬯🬰🬱🬲🬳🬴
16|  a  aaa  a  aaa      🬵🬶🬷🬸🬹🬺🬻█
17| a a a aaaaaaaaa              
18| a a a a a a a a              
19|  a  aaa  a  aaa              
20|        a a a a               
21|aaaaaaaaaaaaaaaa              
22|  a  aaa  a  aaa              
23| a a a aaaaaaaaa              
24|aaaaaaaaaaaaaaaa              
25|  a  aaa  a  aaa              
26|        a a a a               
27|                              
28|  a  aaa  a  aaa              
29|[No Name] [+]  1,1         Top
30|                              

--|---------|---------|---------|
01|000000000000000000001233333333
02|000000000000000000001233333333
03|000000000000000000001233333333
04|000000000000000000001222222222
05|000000000000000000001233333333
06|000000000000000000001222222222
07|000000000000000000001233333333
08|000000000000000000001222222222
09|000000000000000000001233333333
10|000000000000000000001233333333
11|000000000000000000002233333333
12|000000000000000000002222222222
13|000000000000000000002233333333
14|000000000000000000002222222222
15|000000000000000000002233333333
16|000000000000000000002222222222
17|000000000000000000004444444444
18|000000000000000000004444444444
19|000000000000000000004444444444
20|000000000000000000004444444444
21|000000000000000000004444444444
22|000000000000000000004444444444
23|000000000000000000004444444444
24|000000000000000000004444444444
25|000000000000000000004444444444
26|000000000000000000004444444444
27|000000000000000000004444444444
28|000000000000000000004444444444
29|555555555555555555555555555555
30|666666666666666666666666666666
