--|---------|---------|---------|---------|---------|---------|---------|---------|
01|┌…ts/dir-files/nested┐┌dir-1─────┐                                              
02|│ dir-1             ││ dir-11  │                                              
03|└────────────────────┘│ dir-12  │                                              
04|~                     └──────────┘                                              
05|~                                                                               
06|~                                                                               
07|~                                                                               
08|~                                                                               
09|[No Name]                                                     0,0-1          All
10|                                                              1,7-5         All 

--|---------|---------|---------|---------|---------|---------|---------|---------|
01|01111111111111111111100111110000002222222222222222222222222222222222222222222222
02|03333333444444444444400333333334405555555555555555555555555555555555555555555555
03|00000000000000000000000666666667705555555555555555555555555555555555555555555555
04|55555555555555555555550000000000005555555555555555555555555555555555555555555555
05|55555555555555555555555555555555555555555555555555555555555555555555555555555555
06|55555555555555555555555555555555555555555555555555555555555555555555555555555555
07|55555555555555555555555555555555555555555555555555555555555555555555555555555555
08|55555555555555555555555555555555555555555555555555555555555555555555555555555555
09|88888888888888888888888888888888888888888888888888888888888888888888888888888888
10|00000000000000000000000000000000000000000000000000000000000000000000000000000000
