--|---------|---------|
01|aaa       █2🬂🬧🬓     
02|   aa               
03|   aa               
04|~                   
05|~                   
06|~                   
07|~                   
08|~                   
09|~                   
10|~                   
11|~                   
12|~                   
13|~                   
14|[No Name] 3,1       
15|                    

--|---------|---------|
01|00000000001233322222
02|00000000004444444444
03|00000000004444444444
04|55555555554444444444
05|55555555554444444444
06|55555555554444444444
07|55555555554444444444
08|55555555554444444444
09|55555555554444444444
10|55555555554444444444
11|55555555554444444444
12|55555555554444444444
13|55555555554444444444
14|66666666666666666666
15|77777777777777777777
