--|---------|---------|---------|
01|        a a a a        🬀🬁🬂🬃🬄🬅🬆
02|a a a a a a a a       🬇🬈🬉🬊🬋🬌🬍🬎
03|  a  aaa  a  aaa    ┃ 🬏🬐🬑🬒🬓▌🬔🬕
04| a a a aaaaaaaaa    ┃ 🬖🬗🬘🬙🬚🬛🬜🬝
05|a a a a a a a a     ┃ 🬞🬟🬠🬡🬢🬣🬤🬥
06|  a  aaa  a  aaa    ┃ 🬦🬧▐🬨🬩🬪🬫🬬
07|        a a a a     █ 🬭🬮🬯🬰🬱🬲🬳🬴
08| a a a a a a a a    ┃ 🬵🬶🬷🬸🬹🬺🬻█
09|  a  aaa  a  aaa              
10| a a a aaaaaaaaa              
11| a a a a a a a a              
12|  a  aaa  a  aaa              
13|        a a a a               
14|aaaaaaaaaaaaaaaa              
15|  a  aaa  a  aaa              
16| a a a aaaaaaaaa              
17|aaaaaaaaaaaaaaaa              
18|~                             
19|~                             
20|~                             
21|~                             
22|~                             
23|~                             
24|~                             
25|~                             
26|~                             
27|~                             
28|~                             
29|[No Name] [+]  21,1        Bot
30|                              

--|---------|---------|---------|
01|000000000000000000001111111111
02|000000000000000000001111111111
03|000000000000000000002111111111
04|000000000000000000002111111111
05|000000000000000000002111111111
06|000000000000000000002111111111
07|000000000000000000002111111111
08|000000000000000000002111111111
09|000000000000000000003333333333
10|000000000000000000003333333333
11|000000000000000000003333333333
12|000000000000000000003333333333
13|000000000000000000003333333333
14|000000000000000000003333333333
15|000000000000000000003333333333
16|000000000000000000003333333333
17|000000000000000000003333333333
18|444444444444444444443333333333
19|444444444444444444443333333333
20|444444444444444444443333333333
21|444444444444444444443333333333
22|444444444444444444443333333333
23|444444444444444444443333333333
24|444444444444444444443333333333
25|444444444444444444443333333333
26|444444444444444444443333333333
27|444444444444444444443333333333
28|444444444444444444443333333333
29|555555555555555555555555555555
30|666666666666666666666666666666
