--|---------|---------|
01|   bb     █2🬂🬦🬓     
02|   bb               
03|bb                  
04|aa                  
05|   aa               
06|   aa               
07|~                   
08|~                   
09|~                   
10|~                   
11|~                   
12|~                   
13|~                   
14|[No Name] 4,1       
15|-- INSERT --        

--|---------|---------|
01|00000000001233322222
02|00000000004444444444
03|00000000004444444444
04|00000000004444444444
05|00000000004444444444
06|00000000004444444444
07|55555555554444444444
08|55555555554444444444
09|55555555554444444444
10|55555555554444444444
11|55555555554444444444
12|55555555554444444444
13|55555555554444444444
14|66666666666666666666
15|77777777777788888888
