-|---------|--
1|AAAA        
2|BBBB        
3|< [+] 1,1   
4|1111        
5|2222        
6|3333        
7|< [+] 1,1   
8|            

-|---------|--
1|000000000000
2|000000000000
3|111111111111
4|000000000000
5|000000000000
6|000000000000
7|222222222222
8|333333333333
