--|---------|---------|---------|
01|  a  aaa  a  aaa    █  🬀🬁🬂🬃🬄🬅🬆
02|        a a a a     ┃ 🬇🬈🬉🬊🬋🬌🬍🬎
03|                    ┃ 🬏🬐🬑🬒🬓▌🬔🬕
04|+--  3 lines: a  aaa┃ 🬖🬗🬘🬙🬚🬛🬜🬝
05|  a  aaa  a  aaa    ┃ 🬞🬟🬠🬡🬢🬣🬤🬥
06|        a a a a     ┃ 🬦🬧▐🬨🬩🬪🬫🬬
07|a a a a a a a a     ┃ 🬭🬮🬯🬰🬱🬲🬳🬴
08|  a  aaa  a  aaa    ┃ 🬵🬶🬷🬸🬹🬺🬻█
09| a a a aaaaaaaaa              
10|a a a a a a a a               
11|  a  aaa  a  aaa              
12|        a a a a               
13| a a a a a a a a              
14|  a  aaa  a  aaa              
15| a a a aaaaaaaaa              
16| a a a a a a a a              
17|  a  aaa  a  aaa              
18|        a a a a               
19|aaaaaaaaaaaaaaaa              
20|  a  aaa  a  aaa              
21| a a a aaaaaaaaa              
22|aaaaaaaaaaaaaaaa              
23|~                             
24|~                             
25|~                             
26|~                             
27|~                             
28|~                             
29|[No Name] [+]  1,1         All
30|                              

--|---------|---------|---------|
01|000000000000000000001222222222
02|000000000000000000001222222222
03|000000000000000000001222222222
04|333333333333333333331222222222
05|000000000000000000001222222222
06|000000000000000000001222222222
07|000000000000000000001222222222
08|000000000000000000001222222222
09|000000000000000000004444444444
10|000000000000000000004444444444
11|000000000000000000004444444444
12|000000000000000000004444444444
13|000000000000000000004444444444
14|000000000000000000004444444444
15|000000000000000000004444444444
16|000000000000000000004444444444
17|000000000000000000004444444444
18|000000000000000000004444444444
19|000000000000000000004444444444
20|000000000000000000004444444444
21|000000000000000000004444444444
22|000000000000000000004444444444
23|555555555555555555554444444444
24|555555555555555555554444444444
25|555555555555555555554444444444
26|555555555555555555554444444444
27|555555555555555555554444444444
28|555555555555555555554444444444
29|666666666666666666666666666666
30|777777777777777777777777777777
