--|---------|---------|---------|
01|bbbbbaaa  a  aaa    █  🬀🬁🬂🬃🬄🬅🬆
02|bbbbb   a a a a     ┃ 🬇🬈🬉🬊🬋🬌🬍🬎
03|bbbbb               ┃ 🬏🬐🬑🬒🬓▌🬔🬕
04|bbbbbaaa  a  aaa    ┃ 🬖🬗🬘🬙🬚🬛🬜🬝
05|bbbbba aaaaaaaaa    ┃ 🬞🬟🬠🬡🬢🬣🬤🬥
06|bbbbb               ┃ 🬦🬧▐🬨🬩🬪🬫🬬
07|bbbbbaaa  a  aaa    ┃ 🬭🬮🬯🬰🬱🬲🬳🬴
08|bbbbb   a a a a     ┃ 🬵🬶🬷🬸🬹🬺🬻█
09|bbbbb a a a a a               
10|bbbbbaaa  a  aaa              
11| a a a aaaaaaaaa              
12|a a a a a a a a               
13|  a  aaa  a  aaa              
14|        a a a a               
15| a a a a a a a a              
16|  a  aaa  a  aaa              
17| a a a aaaaaaaaa              
18| a a a a a a a a              
19|  a  aaa  a  aaa              
20|        a a a a               
21|aaaaaaaaaaaaaaaa              
22|  a  aaa  a  aaa              
23| a a a aaaaaaaaa              
24|aaaaaaaaaaaaaaaa              
25|~                             
26|~                             
27|~                             
28|~                             
29|[No Name] [+]  1,1         All
30|                              

--|---------|---------|---------|
01|000001111111111111112333333333
02|000001111111111111114333333333
03|000001111111111111114333333333
04|000001111111111111114333333333
05|000001111111111111114333333333
06|000001111111111111114333333333
07|000001111111111111114333333333
08|000001111111111111114333333333
09|000001111111111111115555555555
10|000001111111111111115555555555
11|111111111111111111115555555555
12|111111111111111111115555555555
13|111111111111111111115555555555
14|111111111111111111115555555555
15|111111111111111111115555555555
16|111111111111111111115555555555
17|111111111111111111115555555555
18|111111111111111111115555555555
19|111111111111111111115555555555
20|111111111111111111115555555555
21|111111111111111111115555555555
22|111111111111111111115555555555
23|111111111111111111115555555555
24|111111111111111111115555555555
25|555555555555555555555555555555
26|555555555555555555555555555555
27|555555555555555555555555555555
28|555555555555555555555555555555
29|666666666666666666666666666666
30|777777777777777777777777777777
