--|---------|---------|
01|   bb     ┃2🬭🬉🬄     
02|   bb     █2🬂🬦🬓     
03|bb                  
04|aa                  
05|   aa               
06|   aa               
07|~                   
08|~                   
09|~                   
10|~                   
11|~                   
12|~                   
13|~                   
14|<ame] [+] 4,1    All
15|                    

--|---------|---------|
01|00000000001122233333
02|00000000004122233333
03|00000000005555555555
04|00000000005555555555
05|00000000005555555555
06|00000000005555555555
07|66666666665555555555
08|66666666665555555555
09|66666666665555555555
10|66666666665555555555
11|66666666665555555555
12|66666666665555555555
13|66666666665555555555
14|77777777777777777777
15|88888888888888888888
