--|---------|---------|---------|
01|  a  aaa  a  aaa      🬀🬁🬂🬃🬄🬅🬆 
02|        a a a a      🬇🬈🬉🬊🬋🬌🬍🬎 
03|                     🬏🬐🬑🬒🬓▌🬔🬕 
04|  a  aaa  a  aaa     🬖🬗🬘🬙🬚🬛🬜🬝 
05| a a a aaaaaaaaa     🬞🬟🬠🬡🬢🬣🬤🬥 
06|                     🬦🬧▐🬨🬩🬪🬫🬬 
07|  a  aaa  a  aaa     🬭🬮🬯🬰🬱🬲🬳🬴 
08|        a a a a      🬵🬶🬷🬸🬹🬺🬻█ 
09|a a a a a a a a               
10|  a  aaa  a  aaa              
11| a a a aaaaaaaaa              
12|a a a a a a a a               
13|  a  aaa  a  aaa              
14|        a a a a               
15| a a a a a a a a              
16|  a  aaa  a  aaa              
17| a a a aaaaaaaaa              
18| a a a a a a a a              
19|  a  aaa  a  aaa              
20|        a a a a               
21|aaaaaaaaaaaaaaaa              
22|  a  aaa  a  aaa              
23| a a a aaaaaaaaa              
24|aaaaaaaaaaaaaaaa              
25|~                             
26|~                             
27|~                             
28|~                             
29|[No Name] 1,1                 
30|                              

--|---------|---------|---------|
01|000000000000000000001111111111
02|000000000000000000001111111111
03|000000000000000000001111111111
04|000000000000000000001111111111
05|000000000000000000001111111111
06|000000000000000000001111111111
07|000000000000000000001111111111
08|000000000000000000001111111111
09|000000000000000000002222222222
10|000000000000000000002222222222
11|000000000000000000002222222222
12|000000000000000000002222222222
13|000000000000000000002222222222
14|000000000000000000002222222222
15|000000000000000000002222222222
16|000000000000000000002222222222
17|000000000000000000002222222222
18|000000000000000000002222222222
19|000000000000000000002222222222
20|000000000000000000002222222222
21|000000000000000000002222222222
22|000000000000000000002222222222
23|000000000000000000002222222222
24|000000000000000000002222222222
25|333333333333333333332222222222
26|333333333333333333332222222222
27|333333333333333333332222222222
28|333333333333333333332222222222
29|444444444444444444444444444444
30|555555555555555555555555555555
