--|---------|---------|---------|
01|aa aa aa            █         
02|aa aa aa                      
03|aa aa aa                      
04|aa aa aa                      
05|aa aa aa                      
06|aa aa aa                      
07|aa aa aa                      
08|aa aa aa                      
09|aa aa aa                      
10|aa aa aa                      
11|aa aa aa                      
12|aa aa aa                      
13|aa aa aa                      
14|aa aa aa                      
15|aa aa aa                      
16|aa aa aa                      
17|aa aa aa                      
18|aa aa aa                      
19|aa aa aa                      
20|aa aa aa                      
21|aa aa aa                      
22|aa aa aa                      
23|aa aa aa                      
24|aa aa aa                      
25|~                             
26|~                             
27|~                             
28|~                             
29|[No Name] 15,1                
30|                              

--|---------|---------|---------|
01|000000000000000000001222222222
02|000000000000000000003333333333
03|000000000000000000003333333333
04|000000000000000000003333333333
05|000000000000000000003333333333
06|000000000000000000003333333333
07|000000000000000000003333333333
08|000000000000000000003333333333
09|000000000000000000003333333333
10|000000000000000000003333333333
11|000000000000000000003333333333
12|000000000000000000003333333333
13|000000000000000000003333333333
14|000000000000000000003333333333
15|000000000000000000003333333333
16|000000000000000000003333333333
17|000000000000000000003333333333
18|000000000000000000003333333333
19|000000000000000000003333333333
20|000000000000000000003333333333
21|000000000000000000003333333333
22|000000000000000000003333333333
23|000000000000000000003333333333
24|000000000000000000003333333333
25|444444444444444444443333333333
26|444444444444444444443333333333
27|444444444444444444443333333333
28|444444444444444444443333333333
29|555555555555555555555555555555
30|666666666666666666666666666666
