-|---------|--
1|AAAA  │AAAA 
2|BBBB  │BBBB 
3|<] 1,1 <] 1,
4|1111        
5|2222        
6|3333        
7|< [+] 1,1   
8|            

-|---------|--
1|000000122222
2|000000122222
3|333333344444
4|222222222222
5|222222222222
6|222222222222
7|444444444444
8|222222222222
