--|---------|---------|---------|---------|---------|---------|---------|---------|
01|┌MOCK_ROOT/tests/dir-files┐┌dir-1────────────────────┐                          
02|│ dir-1                  ││ dir-11                 │                          
03|└─────────────────────────┘│ dir-12                 │                          
04|~                          └─────────────────────────┘                          
05|~                                                                               
06|~                                                                               
07|~                                                                               
08|~                                                                               
09|[No Name]                                                     0,0-1          All
10|                                                              1,9-7         All 

--|---------|---------|---------|---------|---------|---------|---------|---------|
01|01111111111111111111111111001111100000000000000000000022222222222222222222222222
02|03333333444444444444444444003333333344444444444444444055555555555555555555555555
03|00000000000000000000000000006666666677777777777777777055555555555555555555555555
04|55555555555555555555555555500000000000000000000000000055555555555555555555555555
05|55555555555555555555555555555555555555555555555555555555555555555555555555555555
06|55555555555555555555555555555555555555555555555555555555555555555555555555555555
07|55555555555555555555555555555555555555555555555555555555555555555555555555555555
08|55555555555555555555555555555555555555555555555555555555555555555555555555555555
09|88888888888888888888888888888888888888888888888888888888888888888888888888888888
10|00000000000000000000000000000000000000000000000000000000000000000000000000000000
