--|---------|---------|---------|
01|  a  aaa  a  aaa    ┃8 🬀🬁🬂🬃🬄🬅🬆
02|        a a a a     ┃3🬇🬈🬉🬊🬋🬌🬍🬎
03|                    ┃ 🬏🬐🬑🬒🬓▌🬔🬕
04|  a  aaa  a  aaa    ┃ 🬖🬗🬘🬙🬚🬛🬜🬝
05| a a a aaaaaaaaa    █ 🬞🬟🬠🬡🬢🬣🬤🬥
06|                    ┃ 🬦🬧▐🬨🬩🬪🬫🬬
07|  a  aaa  a  aaa    ┃ 🬭🬮🬯🬰🬱🬲🬳🬴
08|        a a a a     ┃ 🬵🬶🬷🬸🬹🬺🬻█
09|a a a a a a a a               
10|  a  aaa  a  aaa              
11| a a a aaaaaaaaa              
12|a a a a a a a a               
13|  a  aaa  a  aaa              
14|        a a a a               
15| a a a a a a a a              
16|  a  aaa  a  aaa              
17| a a a aaaaaaaaa              
18| a a a a a a a a              
19|  a  aaa  a  aaa              
20|        a a a a               
21|aaaaaaaaaaaaaaaa              
22|  a  aaa  a  aaa              
23| a a a aaaaaaaaa              
24|aaaaaaaaaaaaaaaa              
25|~                             
26|~                             
27|~                             
28|~                             
29|[No Name] [+]  15,1        All
30|                              

--|---------|---------|---------|
01|000000000000000000001122222222
02|000000000000000000001122222222
03|000000000000000000001344444444
04|000000000000000000001355555555
05|000000000000000000006322222222
06|000000000000000000001333333333
07|000000000000000000001333333333
08|000000000000000000001322222222
09|000000000000000000007777777777
10|000000000000000000007777777777
11|000000000000000000007777777777
12|000000000000000000007777777777
13|000000000000000000007777777777
14|000000000000000000007777777777
15|000000000000000000007777777777
16|000000000000000000007777777777
17|000000000000000000007777777777
18|000000000000000000007777777777
19|000000000000000000007777777777
20|000000000000000000007777777777
21|000000000000000000007777777777
22|000000000000000000007777777777
23|000000000000000000007777777777
24|000000000000000000007777777777
25|888888888888888888887777777777
26|888888888888888888887777777777
27|888888888888888888887777777777
28|888888888888888888887777777777
29|999999999999999999999999999999
30|::::::::::::::::::::::::::::::
