--|---------|---------|---------|
01|█ 🬀🬁🬂🬃🬄🬅🬆      a              
02|┃🬇🬈🬉🬊🬋🬌🬍🬎                     
03|┃🬏🬐🬑🬒🬓▌🬔🬕                     
04|┃🬖🬗🬘🬙🬚🬛🬜🬝      a              
05|┃🬞🬟🬠🬡🬢🬣🬤🬥      a              
06|┃🬦🬧▐🬨🬩🬪🬫🬬                     
07|┃🬭🬮🬯🬰🬱🬲🬳🬴      a              
08|┃🬵🬶🬷🬸🬹🬺🬻█                     
09|                              
10|               a              
11|               a              
12|                              
13|               a              
14|                              
15|               a              
16|               a              
17|               a              
18|               a              
19|               a              
20|                              
21|               a              
22|               a              
23|               a              
24|               a              
25|                              
26|                              
27|                              
28|                              
29|[No Name] [+]  1,1         All
30|                              

--|---------|---------|---------|
01|011111111111111222222222222222
02|311111111111111222222222222222
03|311111111111111222222222222222
04|311111111111111222222222222222
05|311111111111111222222222222222
06|311111111111111222222222222222
07|311111111111111222222222222222
08|311111111111111222222222222222
09|444444444444444222222222222222
10|444444444444444222222222222222
11|444444444444444222222222222222
12|444444444444444222222222222222
13|444444444444444222222222222222
14|444444444444444222222222222222
15|444444444444444222222222222222
16|444444444444444222222222222222
17|444444444444444222222222222222
18|444444444444444222222222222222
19|444444444444444222222222222222
20|444444444444444222222222222222
21|444444444444444222222222222222
22|444444444444444222222222222222
23|444444444444444222222222222222
24|444444444444444222222222222222
25|444444444444444555555555555555
26|444444444444444555555555555555
27|444444444444444555555555555555
28|444444444444444555555555555555
29|666666666666666666666666666666
30|777777777777777777777777777777
