--|---------|---------|---------|
01|  a  aaa  a  aaa    █  🬀🬁🬂🬃🬄🬅🬆
02|        a a a a     ┃ 🬇🬈🬉🬊🬋🬌🬍🬎
03|                    ┃ 🬏🬐🬑🬒🬓▌🬔🬕
04|+--  3 lines: a  aaa┃ 🬖🬗🬘🬙🬚🬛🬜🬝
05|  a  aaa  a  aaa    ┃ 🬞🬟🬠🬡🬢🬣🬤🬥
06|        a a a a     ┃ 🬦🬧▐🬨🬩🬪🬫🬬
07|a a a a a a a a     ┃ 🬭🬮🬯🬰🬱🬲🬳🬴
08|  a  aaa  a  aaa    ┃ 🬵🬶🬷🬸🬹🬺🬻█
09| a a a aaaaaaaaa              
10|a a a a a a a a               
11|  a  aaa  a  aaa              
12|        a a a a               
13| a a a a a a a a              
14|  a  aaa  a  aaa              
15| a a a aaaaaaaaa              
16| a a a a a a a a              
17|  a  aaa  a  aaa              
18|        a a a a               
19|aaaaaaaaaaaaaaaa              
20|  a  aaa  a  aaa              
21| a a a aaaaaaaaa              
22|aaaaaaaaaaaaaaaa              
23|~                             
24|~                             
25|~                             
26|~                             
27|~                             
28|~                             
29|[No Name] [+]  1,1         All
30|                              

--|---------|---------|---------|
01|000000000000000000001222222222
02|000000000000000000003222222222
03|000000000000000000003222222222
04|444444444444444444443222222222
05|000000000000000000003222222222
06|000000000000000000003222222222
07|000000000000000000003222222222
08|000000000000000000003222222222
09|000000000000000000005555555555
10|000000000000000000005555555555
11|000000000000000000005555555555
12|000000000000000000005555555555
13|000000000000000000005555555555
14|000000000000000000005555555555
15|000000000000000000005555555555
16|000000000000000000005555555555
17|000000000000000000005555555555
18|000000000000000000005555555555
19|000000000000000000005555555555
20|000000000000000000005555555555
21|000000000000000000005555555555
22|000000000000000000005555555555
23|666666666666666666665555555555
24|666666666666666666665555555555
25|666666666666666666665555555555
26|666666666666666666665555555555
27|666666666666666666665555555555
28|666666666666666666665555555555
29|777777777777777777777777777777
30|888888888888888888888888888888
