--|---------|---------|---------|
01|▒ uuu               █2█▌      
02|▒ vvv               ┃2█▌      
03|  aaa               ┃3█▌      
04|▒ bbb               ┃3█▌      
05|  ddd               ┃ 🬂🬀      
06|▒ EEE                         
07|▒ FFF                         
08|▒ GGG                         
09|▒ HHH                         
10|▒ III                         
11|▒ JJJ                         
12|▒ KKK                         
13|▒ LLL                         
14|~                             
15|~                             
16|~                             
17|~                             
18|~                             
19|[No Name] 1,1                 
20|                              

--|---------|---------|---------|
01|001111111111111111112344333333
02|001111111111111111112355333333
03|661111111111111111112377333333
04|881111111111111111112344333333
05|661111111111111111112344333333
06|99111111111111111111::::::::::
07|99111111111111111111::::::::::
08|99111111111111111111::::::::::
09|99111111111111111111::::::::::
10|99111111111111111111::::::::::
11|99111111111111111111::::::::::
12|99111111111111111111::::::::::
13|99111111111111111111::::::::::
14|66666666666666666666::::::::::
15|66666666666666666666::::::::::
16|66666666666666666666::::::::::
17|66666666666666666666::::::::::
18|66666666666666666666::::::::::
19|;;;;;;;;;;;;;;;;;;;;;;;;;;;;;;
20|<<<<<<<<<<<<<<<<<<<<<<<<<<<<<<
