--|---------|---------|---------|
01|█ 🬀🬁🬂🬃🬄🬅🬆      a              
02|┃🬇🬈🬉🬊🬋🬌🬍🬎                     
03|┃🬏🬐🬑🬒🬓▌🬔🬕                     
04|┃🬖🬗🬘🬙🬚🬛🬜🬝      a              
05|┃🬞🬟🬠🬡🬢🬣🬤🬥      a              
06|┃🬦🬧▐🬨🬩🬪🬫🬬                     
07|┃🬭🬮🬯🬰🬱🬲🬳🬴      a              
08|┃🬵🬶🬷🬸🬹🬺🬻█                     
09|                              
10|               a              
11|               a              
12|                              
13|               a              
14|                              
15|               a              
16|               a              
17|               a              
18|               a              
19|               a              
20|                              
21|               a              
22|               a              
23|               a              
24|               a              
25|                              
26|                              
27|                              
28|                              
29|[No Name] [+]  1,1         All
30|                              

--|---------|---------|---------|
01|011111111111111222222222222222
02|011111111111111222222222222222
03|011111111111111222222222222222
04|011111111111111222222222222222
05|011111111111111222222222222222
06|011111111111111222222222222222
07|011111111111111222222222222222
08|011111111111111222222222222222
09|333333333333333222222222222222
10|333333333333333222222222222222
11|333333333333333222222222222222
12|333333333333333222222222222222
13|333333333333333222222222222222
14|333333333333333222222222222222
15|333333333333333222222222222222
16|333333333333333222222222222222
17|333333333333333222222222222222
18|333333333333333222222222222222
19|333333333333333222222222222222
20|333333333333333222222222222222
21|333333333333333222222222222222
22|333333333333333222222222222222
23|333333333333333222222222222222
24|333333333333333222222222222222
25|333333333333333444444444444444
26|333333333333333444444444444444
27|333333333333333444444444444444
28|333333333333333444444444444444
29|555555555555555555555555555555
30|666666666666666666666666666666
