--|---------|---------|---------|
01|  a  aaa  a  aaa    ┃6 🬀🬁🬂🬃🬄🬅🬆
02|        a a a a     ┃5🬇🬈🬉🬊🬋🬌🬍🬎
03|                    ┃+🬏🬐🬑🬒🬓▌🬔🬕
04|  a  aaa  a  aaa    ┃+🬖🬗🬘🬙🬚🬛🬜🬝
05| a a a aaaaaaaaa    █+🬞🬟🬠🬡🬢🬣🬤🬥
06|                    ┃+🬦🬧▐🬨🬩🬪🬫🬬
07|  a  aaa  a  aaa    ┃6🬭🬮🬯🬰🬱🬲🬳🬴
08|        a a a a     ┃5🬵🬶🬷🬸🬹🬺🬻█
09|a a a a a a a a               
10|  a  aaa  a  aaa              
11| a a a aaaaaaaaa              
12|a a a a a a a a               
13|  a  aaa  a  aaa              
14|        a a a a               
15| a a a a a a a a              
16|  a  aaa  a  aaa              
17| a a a aaaaaaaaa              
18| a a a a a a a a              
19|  a  aaa  a  aaa              
20|        a a a a               
21|aaaaaaaaaaaaaaaa              
22|  a  aaa  a  aaa              
23| a a a aaaaaaaaa              
24|aaaaaaaaaaaaaaaa              
25|~                             
26|~                             
27|~                             
28|~                             
29|[No Name] 15,10               
30|/\<a\> ... [49/76]            

--|---------|---------|---------|
01|001000000010000000002344444444
02|000000001010101000002344444444
03|000000000000000000002344444444
04|001000000010000000002344444444
05|010101000000000000002344444444
06|000000000000000000002344444444
07|001000000010000000002344444444
08|000000001010101000002344444444
09|101010101010101000005555555555
10|001000000010000000005555555555
11|010101000000000000005555555555
12|101010101010101000005555555555
13|001000000010000000005555555555
14|000000001010101000005555555555
15|010101010601010100005555555555
16|001000000010000000005555555555
17|010101000000000000005555555555
18|010101010101010100005555555555
19|001000000010000000005555555555
20|000000001010101000005555555555
21|000000000000000000005555555555
22|001000000010000000005555555555
23|010101000000000000005555555555
24|000000000000000000005555555555
25|777777777777777777775555555555
26|777777777777777777775555555555
27|777777777777777777775555555555
28|777777777777777777775555555555
29|888888888888888888888888888888
30|999999999999999999999999999999
