--|---------|---------|---------|
01|  a  aaa  a  aaa    █2 🬀🬁🬂🬃🬄🬅🬆
02|        a a a a     ┃ 🬇🬈🬉🬊🬋🬌🬍🬎
03|                    ┃ 🬏🬐🬑🬒🬓▌🬔🬕
04|  a  aaa  a  aaa    ┃ 🬖🬗🬘🬙🬚🬛🬜🬝
05| a a a aaaaaaaaa    ┃ 🬞🬟🬠🬡🬢🬣🬤🬥
06|                    ┃ 🬦🬧▐🬨🬩🬪🬫🬬
07|  a  aaa  a  aaa    ┃ 🬭🬮🬯🬰🬱🬲🬳🬴
08|        a a a a     ┃ 🬵🬶🬷🬸🬹🬺🬻█
09|a a a a a a a a     ┃2 🬀🬁🬂🬃🬄🬅🬆
10|  a  aaa  a  aaa    ┃ 🬇🬈🬉🬊🬋🬌🬍🬎
11| a a a aaaaaaaaa      🬏🬐🬑🬒🬓▌🬔🬕
12|a a a a a a a a       🬖🬗🬘🬙🬚🬛🬜🬝
13|  a  aaa  a  aaa      🬞🬟🬠🬡🬢🬣🬤🬥
14|        a a a a       🬦🬧▐🬨🬩🬪🬫🬬
15| a a a a a a a a      🬭🬮🬯🬰🬱🬲🬳🬴
16|  a  aaa  a  aaa      🬵🬶🬷🬸🬹🬺🬻█
17| a a a aaaaaaaaa              
18| a a a a a a a a              
19|  a  aaa  a  aaa              
20|        a a a a               
21|aaaaaaaaaaaaaaaa              
22|  a  aaa  a  aaa              
23| a a a aaaaaaaaa              
24|aaaaaaaaaaaaaaaa              
25|  a  aaa  a  aaa              
26|        a a a a               
27|                              
28|  a  aaa  a  aaa              
29|[No Name] [+]  1,1         Top
30|                              

--|---------|---------|---------|
01|000000000000000000001233333333
02|000000000000000000002433333333
03|000000000000000000002433333333
04|000000000000000000002444444444
05|000000000000000000002433333333
06|000000000000000000002444444444
07|000000000000000000002433333333
08|000000000000000000002444444444
09|000000000000000000002233333333
10|000000000000000000002433333333
11|000000000000000000004433333333
12|000000000000000000004444444444
13|000000000000000000004433333333
14|000000000000000000004444444444
15|000000000000000000004433333333
16|000000000000000000004444444444
17|000000000000000000005555555555
18|000000000000000000005555555555
19|000000000000000000005555555555
20|000000000000000000005555555555
21|000000000000000000005555555555
22|000000000000000000005555555555
23|000000000000000000005555555555
24|000000000000000000005555555555
25|000000000000000000005555555555
26|000000000000000000005555555555
27|000000000000000000005555555555
28|000000000000000000005555555555
29|666666666666666666666666666666
30|777777777777777777777777777777
