--|---------|---------|---------|
01|  a  aaa  a  aaa           >< 
02|        a a a a            ┃  
03|                           ┃  
04|  a  aaa  a  aaa           ┃  
05| a a a aaaaaaaaa           ┃  
06|                           ┃  
07|  a  aaa  a  aaa           ┃  
08|        a a a a            ┃  
09|a a a a a a a a            ┃  
10|  a  aaa  a  aaa           ┃  
11| a a a aaaaaaaaa           ┃  
12|a a a a a a a a            ┃  
13|  a  aaa  a  aaa           ┃  
14|        a a a a            ┃  
15| a a a a a a a a           ┃  
16|  a  aaa  a  aaa           ┃  
17| a a a aaaaaaaaa           ┃  
18| a a a a a a a a           ┃  
19|  a  aaa  a  aaa           ┃  
20|        a a a a            ┃  
21|aaaaaaaaaaaaaaaa           ┃  
22|  a  aaa  a  aaa           ┃  
23| a a a aaaaaaaaa           ┃  
24|aaaaaaaaaaaaaaaa           ┃  
25|~                          ┃  
26|~                          ┃  
27|~                          ┃  
28|~                             
29|[No Name] [+]  1,1         All
30|                              

--|---------|---------|---------|
01|000000000000000000000000000112
02|000000000000000000000000000122
03|000000000000000000000000000122
04|000000000000000000000000000122
05|000000000000000000000000000122
06|000000000000000000000000000122
07|000000000000000000000000000122
08|000000000000000000000000000122
09|000000000000000000000000000122
10|000000000000000000000000000122
11|000000000000000000000000000122
12|000000000000000000000000000122
13|000000000000000000000000000122
14|000000000000000000000000000122
15|000000000000000000000000000122
16|000000000000000000000000000122
17|000000000000000000000000000122
18|000000000000000000000000000122
19|000000000000000000000000000122
20|000000000000000000000000000122
21|000000000000000000000000000122
22|000000000000000000000000000122
23|000000000000000000000000000122
24|000000000000000000000000000122
25|333333333333333333333333333122
26|333333333333333333333333333122
27|333333333333333333333333333122
28|333333333333333333333333333222
29|444444444444444444444444444444
30|555555555555555555555555555555
