--|---------|---------|---------|
01|  a  aaa  a  aaa    > 12341234
02|        a a a a     + 11112222
03|                    + 11111111
04|  a  aaa  a  aaa    + 12341234
05| a a a aaaaaaaaa    + 33334444
06|                    + 11111111
07|  a  aaa  a  aaa    + 12341234
08|        a a a a     + 11112222
09|a a a a a a a a     + 22222222
10|  a  aaa  a  aaa    + 12341234
11| a a a aaaaaaaaa    + 33334444
12|a a a a a a a a     + 22222222
13|  a  aaa  a  aaa    + 12341234
14|        a a a a     + 11112222
15| a a a a a a a a    + 33333333
16|  a  aaa  a  aaa    + 12341234
17| a a a aaaaaaaaa    + 33334444
18| a a a a a a a a    + 33333333
19|  a  aaa  a  aaa    + 12341234
20|        a a a a     + 11112222
21|aaaaaaaaaaaaaaaa    + 44444444
22|  a  aaa  a  aaa    + 12341234
23| a a a aaaaaaaaa    + 33334444
24|aaaaaaaaaaaaaaaa    + 44444444
25|~                             
26|~                             
27|~                             
28|~                             
29|[No Name] [+]  1,1         All
30|                              

--|---------|---------|---------|
01|000000000000000000001222222222
02|000000000000000000003222222222
03|000000000000000000003222222222
04|000000000000000000003222222222
05|000000000000000000003222222222
06|000000000000000000003222222222
07|000000000000000000003222222222
08|000000000000000000003222222222
09|000000000000000000003222222222
10|000000000000000000003222222222
11|000000000000000000003222222222
12|000000000000000000003222222222
13|000000000000000000003222222222
14|000000000000000000003222222222
15|000000000000000000003222222222
16|000000000000000000003222222222
17|000000000000000000003222222222
18|000000000000000000003222222222
19|000000000000000000003222222222
20|000000000000000000003222222222
21|000000000000000000003222222222
22|000000000000000000003222222222
23|000000000000000000003222222222
24|000000000000000000003222222222
25|444444444444444444445555555555
26|444444444444444444445555555555
27|444444444444444444445555555555
28|444444444444444444445555555555
29|666666666666666666666666666666
30|777777777777777777777777777777
