--|---------|---------|---------|
01|  a  aaa  a  aaa    █  🬀🬁🬂🬃🬄🬅🬆
02|        a a a a     ┃ 🬇🬈🬉🬊🬋🬌🬍🬎
03|                    ┃ 🬏🬐🬑🬒🬓▌🬔🬕
04|  a  aaa  a  aaa    ┃ 🬖🬗🬘🬙🬚🬛🬜🬝
05| a a a aaaaaaaaa    ┃ 🬞🬟🬠🬡🬢🬣🬤🬥
06|                    ┃ 🬦🬧▐🬨🬩🬪🬫🬬
07|  a  aaa  a  aaa    ┃ 🬭🬮🬯🬰🬱🬲🬳🬴
08|        a a a a     ┃ 🬵🬶🬷🬸🬹🬺🬻█
09|a a a a a a a a     ┃  🬀🬁🬂🬃🬄🬅🬆
10|  a  aaa  a  aaa    ┃ 🬇🬈🬉🬊🬋🬌🬍🬎
11| a a a aaaaaaaaa      🬏🬐🬑🬒🬓▌🬔🬕
12|a a a a a a a a       🬖🬗🬘🬙🬚🬛🬜🬝
13|  a  aaa  a  aaa      🬞🬟🬠🬡🬢🬣🬤🬥
14|        a a a a       🬦🬧▐🬨🬩🬪🬫🬬
15| a a a a a a a a      🬭🬮🬯🬰🬱🬲🬳🬴
16|  a  aaa  a  aaa      🬵🬶🬷🬸🬹🬺🬻█
17| a a a aaaaaaaaa              
18| a a a a a a a a              
19|  a  aaa  a  aaa              
20|        a a a a               
21|aaaaaaaaaaaaaaaa              
22|  a  aaa  a  aaa              
23| a a a aaaaaaaaa              
24|aaaaaaaaaaaaaaaa              
25|  a  aaa  a  aaa              
26|        a a a a               
27|                              
28|  a  aaa  a  aaa              
29|[No Name] 1,1                 
30|                              

--|---------|---------|---------|
01|000000000000000000001222222222
02|000000000000000000001222222222
03|000000000000000000001222222222
04|000000000000000000001222222222
05|000000000000000000001222222222
06|000000000000000000001222222222
07|000000000000000000001222222222
08|000000000000000000001222222222
09|000000000000000000001222222222
10|000000000000000000001222222222
11|000000000000000000002222222222
12|000000000000000000002222222222
13|000000000000000000002222222222
14|000000000000000000002222222222
15|000000000000000000002222222222
16|000000000000000000002222222222
17|000000000000000000003333333333
18|000000000000000000003333333333
19|000000000000000000003333333333
20|000000000000000000003333333333
21|000000000000000000003333333333
22|000000000000000000003333333333
23|000000000000000000003333333333
24|000000000000000000003333333333
25|000000000000000000003333333333
26|000000000000000000003333333333
27|000000000000000000003333333333
28|000000000000000000003333333333
29|444444444444444444444444444444
30|555555555555555555555555555555
