-|---------|--
1|AAAA  │AAAA 
2|BBBB  │BBBB 
3|<] 1,1 <] 1,
4|1111        
5|2222        
6|3333        
7|< [+] 1,1   
8|            

-|---------|--
1|000000100000
2|000000100000
3|222222233333
4|000000000000
5|000000000000
6|000000000000
7|333333333333
8|111111111111
