--|---------|---------|---------|---------|---------|---------|---------|---------|
01|┌MOCK_ROOT/tests/dir-files┐┌dir-1────────────────────┐                          
02|│ dir-1                  ││ dir-11                 │                          
03|└─────────────────────────┘│ dir-12                 │                          
04|~                          └─────────────────────────┘                          
05|~                                                                               
06|~                                                                               
07|~                                                                               
08|~                                                                               
09|~                                                                               
10|                                                              1,9-7         All 

--|---------|---------|---------|---------|---------|---------|---------|---------|
01|01111111111111111111111111002222200000000000000000000033333333333333333333333333
02|04444444555555555555555555004444444455555555555555555066666666666666666666666666
03|00000000000000000000000000007777777788888888888888888066666666666666666666666666
04|66666666666666666666666666600000000000000000000000000066666666666666666666666666
05|66666666666666666666666666666666666666666666666666666666666666666666666666666666
06|66666666666666666666666666666666666666666666666666666666666666666666666666666666
07|66666666666666666666666666666666666666666666666666666666666666666666666666666666
08|66666666666666666666666666666666666666666666666666666666666666666666666666666666
09|66666666666666666666666666666666666666666666666666666666666666666666666666666666
10|33333333333333333333333333333333333333333333333333333333333333333333333333333333
